Are you happy?	Ты счастлива? 
I don't care as long as you are happy.	До тех пор пока вы довольны, мне всё равно. 
We are happy to have you join our team.	Мы счастливы, что Вы присоединились к нашей команде. 
Why are you so happy?	Ты почему такой счастливый? 
I am happy to have so many good friends.	Я счастлив иметь так много хороших друзей. 
I wish you a Happy New Year.	С Новым годом! 
All were happy.	Все были счастливы. 
All happy families resemble each other, each unhappy family is unhappy in its own way.	Все счастливые семьи похожи друг на друга, каждая несчастливая семья несчастлива по-своему. 
Can you guess how happy I am?	Можешь представить, как я счастлив? 
Never have I been so happy.	Я никогда не был так счастлив. 
This album reminds me of my happy school days.	Этот альбом напоминает мне о счастливых школьных днях. 
Happy birthday to you!	С днём рождения! 
I am happy to hear your voice.	Я рад слышать твой голос. 
I'll make you happy.	Я сделаю тебя счастливой. 
I'm very happy now.	Сейчас я очень счастлив. 
I'm very happy.	Я очень счастлив. 
I was happy yesterday.	Вчера я был счастлив. 
I want to make her happy.	Я хочу сделать её счастливой. 
If it were not for exams, we would be happy.	Если бы не экзамены, мы были бы счастливы. 
If you need more information, we are happy to send it.	Если вам нужно больше информации, мы будем рады её вам переслать. 
Everybody wants to live a happy life.	Все хотят жить счастливой жизнью. 
He said that he was very happy.	Он сказал, что очень счастлив. 
He made her happy.	Он сделал её счастливой. 
Poor as he is, he is happy.	Он небогат, но счастлив. 
They are happy.	Они счастливы. 
She looks happy on hearing the news.	Услышав эту новость, она выглядит счастливой. 
She looks very happy.	Она выглядит очень счастливой. 
She looks happy.	Она выглядит счастливой. 
I don't think she is happy.	Не думаю, что она счастлива. 
She said that she had been happy.	Она сказала, что была счастлива. 
She is poor, but she looks happy.	Она бедна, но выглядит счастливой. 
Despite all his fame, he is not happy.	Несмотря на всю его славу, его нельзя назвать счастливым. 
Happy birthday, Muiriel!	С днём рождения, Мюриэл! 
Happy New Year!	С новым годом! 
I'm happy, cause I'm learning some Dutch.	Я рад, потому что я немножко учу голландский. 
If you smile, I'll be happy.	Если ты улыбнёшься, я буду счастлив. 
I'm not happy with this situation.	Я этой ситуацией не доволен. 
I'm very happy to see you.	Очень счастлив тебя видеть. 
We are happy.	Мы счастливы. 
I'm sure that he's happy.	Я уверена, что он счастлив. 
Happy birthday!	С днём рождения! 
She is poor, but happy.	Она бедная, но счастливая. 
He is poor, but happy.	Он беден, но счастлив. 
Oranges mean happy love while lemons are for the unanswered one.	Апельсины означают счастливую любовь, тогда как лимоны — безответную. 
She is poor, but she is happy.	Она бедна, но счастлива. 
I am a completely happy human being!	Я вполне счастливый человек! 
After his accident, he is happy to be alive.	После несчастного случая он рад остаться в живых. 
Although he is rich, he is not happy.	Он хоть и богат, но не счастлив. 
Oleg is happy that someone loves him.	Олег счастлив, что его кто-то любит. 
I feel happy when I'm with you.	Я чувствую себя счастливым, когда я с тобой. 
She asked him if he was happy.	Она спросила, счастлив ли он. 
She wouldn't be happy with him.	Она не была бы счастлива с ним. 
Nay, since you will not love, would I were growing A happy daisy, in the garden path That so your silver foot might press me going, Might press me going even unto death.	Счастливой маргариткой у дорожки Взрасту и лягу на земную твердь, И под её серебряною ножкой Покорно обрету желанную мной смерть. 
Are you happy now?	Теперь ты доволен? 
At the start of every weekend, I am both tired and happy.	В начале каждого уикенда я чувствую себя усталым и счастливым одновременно. 
I'm happy because beginning today, we have no school until September.	Я счастлив,потому что с сегодняшнего дня у нас в школе не будет занятий до сентября. 
I'm happy because starting today, we don't have any school until September.	Я счастлив,потому что с сегодняшнего дня у нас в школе не будет занятий до сентября. 
He tried to make his wife happy, but couldn't.	Он старался сделать жену счастливой, но не мог. 
I'm happy to see you here.	Я рад видеть вас здесь. 
She seems happy.	Она выглядит счастливой. 
When I'm with you, I'm happy.	Когда я с тобой, я счастлив. 
The rich are not always happy.	Богатые не всегда счастливы. 
This girl is smiling contantly, but she isn't happy.	Эта девочка постоянно улыбается, однако она не счастлива. 
Though he is wealthy he is not happy.	Хотя он богат, он не счастлив. 
She always looked happy.	Она всегда выглядела счастливой. 
Happy to see you.	Рад тебя видеть. 
A woman wrote 30 books about how to become happy, and then committed suicide.	Одна женщина написала 30 книг о том, как стать счастливой, а потом покончила с собой. 
I am happy to spend money on books.	Я счастлив тратить деньги на книги. 
If I were healthy, I would be happy.	Если бы я был здоров, я был бы счастлив. 
We're all happy.	Мы все счастливы. 
I am very happy in Georgia.	Я очень счастлив в Грузии. 
Those who forget everything are happy.	Те, кто всё забывают, счастливы. 
Bob was very happy.	Боб был очень счастлив. 
That child was happy to get the gift.	Этот ребёнок был счастлив получить подарок. 
He seems to be happy.	Он кажется счастливым. 
Don't worry, be happy.	Не волнуйся, будь счастлив. 
I am happy!	Я счастлива! 
John said he'd like to marry me, and I'm as happy as can be.	Джон сказал, что хочет жениться на мне, и я счастлива как никогда. 
He was not happy at all.	Он был отнюдь не счастлив. 
Compared to those around him, he looked really happy.	По сравнению с окружающими его людьми, он выглядел очень счастливым. 
Happy Thanksgiving Day.	Счастливого Дня Благодарения. 
To all appearances, they are a happy couple.	Во всех проявлениях, они счастливая пара. 
The couple led a happy life.	Пара вела счастливую жизнь. 
Then you will be happy.	Тогда ты будешь счастлив. 
This picture reminds me of our happy days in England.	Эта картина напоминает мне о счастливых днях в Англии. 
I am happy to see you here.	Я рад видеть вас здесь. 
Happy is the child who has such a mother.	Счастлив ребёнок, у которого есть такая мать. 
Everything concurred to make him happy.	Всё совпало, чтобы сделать его счастливым. 
I will be happy to attend your party.	Я буду рад присутствовать на вашей вечеринке. 
I am happy to notify you that I have fully recovered.	Я рад уведомить вас, что я полностью выздоровел. 
I feel happy because I am quit of that trouble.	Я счастлив, потому что я избежал проблем. 
He feels happy in spite of his failure.	Он счастлив, несмотря на свою неудачу. 
Happy New Year, Louise!	С Новым Годом, Луиза! 
He looks as happy as if he had won a trip to Hawaii.	Он выглядит таким счастливым, как будто он выиграл путёвку на Гавайи. 
Though he was poor, he was nonetheless happy.	Хотя и беден, он был тем не менее счастлив. 
Her story brought back our happy childhood.	Её история заставила вспомнить счастливое детство. 
Happy is a man who lives in peace and content.	Счастлив живущий в мире и довольстве. 
Happy Birthday, Miss Aiba!	С днём рождения, мисс Айба. 
She said: "I'm very happy".	Она сказала: "Я очень счастлива". 
You smiled and, just like that, I was happy.	Ты улыбнулась, и этого было достаточно, чтобы я был счастлив. 
Now this is something. What wonderful presents! Boy am I happy!	Вот это да. Какие чудесные подарки! Как я рад! 
That album reminds me of the school happy days.	Этот альбом напоминает мне о счастливых школьных днях. 
We are never as happy or as unhappy as we imagine.	Мы никогда бы бываем настолько счастливы или несчастны как мы себе представляем. 
If he were happy, he would play much better.	Если бы он был счастлив, он бы играл гораздо лучше. 
Buy a hedgehog and you'll be happy.	Купи ежа, и будешь счастлив. 
When you walk sturdily along the path on which you have started, you are, in my opinion, happy.	Когда ты твердо идешь по пути, которым начал идти, то, по моему мнению, ты счастлив. 
I wish I could figure out how to make Tom happy.	Хотел бы я узнать, как сделать Тома счастливее. 
Maybe they are happy.	Может быть, они счастливы. 
We all want to be happy.	мы все хотим быть счастливыми 
Oranges signify a happy love, while lemons - an unrequited one.	Апельсины означают счастливую любовь, тогда как лимоны — безответную. 
Tom doesn’t believe that Mary is happy.	Том не верит, что Мери счастлива. 
I am happy with my girlfriend.	Я счастлив моей подругой. 
Happy New Year!	С Новым годом! 
happy journey!	счастливого пути! 
I am very happy to do this favor for you.	Я очень рад оказать Вам эту услугу. 
I am very happy to have had the opportunity to meet you personally.	Я был счастлив возможности встретиться с Вами лично. 
I'm very happy to do this favor for you.	Я очень рад оказать Вам эту услугу. 
May I take this opportunity to wish you a very happy New Year.	Позвольте воспользоваться случаем и пожелать Вам счастливого Нового года. 
we are very happy to establish business relation with you	Мы рады сотрудничать с Вами 
We will be happy to make hotel reservations on your behalf.	Мы будем рады забронировать для Вас гостиницу. 
We would be happy if you were to publish them.	Будем рады их публикации. 
We would be happy therefore to receive a small consignment of your products on a trial basis to test the market for your products.	В связи с этим мы были бы рады получить от Вас небольшую пробную партию Ваших товаров с целью изучения рыночной конъюнктуры на Ваши продукты. 
We would be happy to receive your order.	Будем рады Вашему заказу. 
When a man is happy he does not hear the clock strike.	Счастливые часов не наблюдают. 
The news in Sarkozy's favored media outletJournal du Dimanche that the couple plan to marry touched off a flurry of fevered speculation on when the happy event might occur.	Новость, прозвучавшая в любимом информационном выпуске Саркози"Journal du Dimanche"o том, что пара собирается пожениться, вызвало шквал лихорадочных предположений о возможной дате этого счастливого события. 
But, the Irish story has not had a happy ending.	Но у ирландской истории нет счастливого конца. 
The IPCC has magnanimously declared that it would have been happy if Gore had received the Nobel Peace prize alone.	МГЭИК великодушно объявил, что он был бы счастлив, если бы только Гор получил Нобелевскую премию. 
In the 1995 election, Yeltsin would have been happy if the NDR secured 25% to 30% of the vote.	В выборах 1995 года Ельцин был бы счастлив если бы "Нашему дому - России" удалось получить 25 - 30% голосов. 
This is the British idea of Europe, and the German Constitutional Court, too, would probably be happy about such a development.	Это - британская идея Европы, и германский Конституционный Суд, вероятно, тоже был бы счастлив увидеть такое развитие. 
That way, the accumulated wealth might make them very happy in their later years.	Тем самым накопленное богатство могло бы сделать их очень счастливыми в более поздние годы. 
Even though people may admire other things, they act as if they are mostly happy enough with whatever they already have, and lack the will to consider real change.	Хотя люди могут восхищаться другими вещами, они действуют так, как будто они, по большей части, вполне довольны тем, что у них уже есть, и им не хватает воли для того, чтобы обдумать реальное изменение. 
But it will require global monetary reform of a fundamental order to right the imbalances between surplus and deficit countries, between happy savers and those who lived beyond their means, and between rich and poor.	Но для этого потребуется глобальная денежная реформа фундаментального порядка, чтобы выровнить дисбалансы между странами с активным платежным балансом и странами с пассивным платежным балансом, между счастливыми владельцами сбережений и теми, кто жил не по средствам, а также между богатыми и бедными. 
Ensuring high-quality output and local consumers' loyalty requires keeping their workforces happy and maintaining a positive public image.	Для обеспечения высокого качества продукции и лояльности местных потребителей необходимо, чтобы работники были довольны и чтобы компания имела положительный имидж в обществе. 
If the China Daily, among other publications, is to be believed, "pre-Liberation" Tibet was a living hell, and Tibetans are now happy and grateful to be citizens of the People's Republic of China.	Если верить China Daily, помимо других публикаций, то жизнь в Тибете "до освобождения" была сущим адом, и жители Тибета теперь счастливы и благодарны быть гражданами Китайской Народной Республики. 
The Chinese government claims that Tibetans are happy.	Китайское правительство утверждает, что жители Тибета счастливы. 
In World War II, German corporations were all too willing to profit from the slave labor of those in concentration camps, and Swiss banks were happy to pocket the gold of Jewish victims of Nazi terror.	Во Второй Мировой Войне все немецкие корпорации очень хотели получать прибыль от рабского труда тех, кто находился в концентрационных лагерях, а швейцарские банки были счастливы положить в карман золото еврейских жертв нацистского террора. 
Like many diplomatic compromises, the outcome left everyone a bit happy and a bit disappointed.	Как и во многих дипломатических компромиссах, результат оставил всех слегка счастливыми и слегка разочарованными. 
In the 2000's, China became the prime source of debt financing, and Americans were happy, because it enabled the US Federal Reserve to keep interest rates low.	В 2000-х годах Китай стал основным источником долгового финансирования, и американцы были счастливы, потому что он позволял американской Федеральной резервной системе сохранять низкие процентные ставки. 
Not everyone is happy with this news.	Не все были счастливы услышать такие новости. 
So perhaps decision makers, faced with the victims of previous policies and the future victims of current ones, would simply be happy that at last they could allocate resources in an optimally efficient way.	Таким образом, возможно, те, кто принимают решения, столкнувшись с жертвами предыдущей политики и будущими жертвами нынешней политики, были бы просто счастливы, наконец-то, распределить ресурсы оптимально эффективным способом. 
Perhaps the Europeans are perfectly happy to work less and enjoy more free time, both in terms of having more vacations during their working age, and spending less time in the active labor force.	Возможно, европейцы совершенно счастливы работать меньше и наслаждаться большим количеством свободного времени с точки зрения и наличия большего количества отпусков в рабочем возрасте, и более короткого жизненного рабочего срока. 
In other words, he was deemed to be healthy and happy.	Другими словами, его считали человеком здоровым и счастливым. 
The ball flashes to and fro in happy irresponsibility - between human will and chance, freedom and limitation, success and failure, hope and the loss of hope - to bounce back into the world of hope in the next moment.	Мяч летает со счастливой безответственностью вперед и назад, меж человеческой волей и случаем, свободой и ограничениями, успехом и неудачами, надеждами и потерями лишь для того, чтобы в следующее мгновение переметнуться обратно в мир надежд. 
The French are happy to hear that.	Французы рады это слышать. 
For his part, the far-right leader, Jean-Marie Le Pen, says that he is very happy with this evolution.	В свою очередь, лидер крайне правых, Жан-Мари Ле Пен, говорит, что очень доволен этой эволюцией. 
Russia may have recovered its status as a strong power, but is it a respected, or even a happy one?	Россия, возможно, вернула свой статус сильной державы, но неужели это уважаемый или даже счастливый статус? 
The banks were happy to earn a few extra pennies on supposedly risk-free assets and loaded up their balance sheets with the weaker countries' government debt.	Банки были счастливы заработать несколько дополнительных пенсов на предположительно безрисковых активах и загрузили свои балансовые отчеты правительственными долгами более слабых стран. 
What has been a sad and sorry saga could have a happy ending if Wolfowitz's successor is chosen in an open, transparent process.	История, которая сейчас выглядит как грустная и достойная сожаления, может иметь и счастливый конец, если преемник Вольфовица будет избран путем открытой, прозрачной процедуры. 
While Egypt's shaky military junta welcomed Erdoğan, many Egyptians were not happy about his hectoring them - and other Arabs - to follow Turkish policies and to regard Turkey as their Muslim leader.	Пока непрочная военная хунта Египта приветствовала Эрдогана, многие египтяне не были счастливы, когда он убеждал их - и других арабов - следовать политике Турции и рассматривать Турцию как своего мусульманского лидера. 
Oz is happy that he left physics.	Оз счастлив, что бросил физику. 
Happy transitions, to paraphrase Tolstoy, are all alike;	Счастливые переходы, перефразируя Толстого, похожи друг на друга; 
The happy transitions across much of Central Europe following the end of the Cold War were made easier by the fact that the old communist order more or less died on its feet and surrendered power peacefully.	Счастливые переходы на большей части Центральной Европы после окончания холодной войны были облегчены тем, что старый коммунистический порядок практически потерпел крах и сдал власть мирным путем. 
We should just be happy that some degree of realism is returning to the World Bank's discussion of globalization.	Нам просто следует быть счастливыми от осознания того, что в обсуждении процессов глобализации Международный банк в некоторой степени возвращается на позиции реализма. 
The Alliance would not be happy to apply Article 5 of the NATO charter, which would oblige its members to fight for Israel if it were attacked by any of its many potential enemies in an endemically dangerous region.	Едва ли Альянс будет рад применить Статью 5 Устава НАТО, обязывающую его членов воевать за Израиль, если тот подвергнется нападению со стороны любого из своих потенциальных противников в этом традиционно опасном регионе. 
Alvaro Uribe of Colombia was happy just to have a US Chief of State visit Bogotá;	Альваро Урибе, президент Колумбии, был рад только тому, чтобы американский глава государства посетил Боготу; 
Some in the Bush administration accept this argument, saying that they are happy to see Latin American democracies seeking influence where the United States cannot.	Некоторые лица в администрации Буша поддерживают эту мысль, говоря о том, что они рады видеть, что латиноамериканские демократии ищут влияние там, где это не могут сделать США. 
The richest taxpayers are, of course, happy because they received the bulk of the tax cuts.	Богатые налогоплательщики, конечно, рады - большая часть налоговых льгот досталась им. 
These are not politicians, but former idealists who are happy that their goals of Islamicizing the state are being realized.	Эти люди - не политики, а бывшие идеалисты, которые рады тому, что их мечты об исламизации государства сбываются. 
Like a happy and secure childhood, Confucian civilization bestowed upon its practitioners the self-confidence to meet the challenge of the West.	Подобно счастливому и безопасному детству, конфуцианская цивилизация придала ее представителям уверенность в себе, необходимую для того, чтобы принять вызов Запада. 
Many government behave as if the economic setback is temporary and happy pre-crisis days will return fairly soon.	Многие правительства ведут себя так, будто бы текущий экономический спад является временным и будто бы довольно скоро вернутся весёлые докризисные времена. 
But, until that happy day arrives, or at least until the two sides have reached the contours of an agreement, direct talks and photo opportunities should be considered counter-productive.	Но пока не придет этот счастливый день или, по крайней мере, пока эти две стороны не достигнут соглашения, прямые переговоры и позирование перед прессой следует считать непродуктивными. 
Somewhere in the recesses of our consciences we know that we should think about those left behind, but we are so happy rushing forward that we fail to look back at what is happening in our new democratic ghettoes.	Где-то в глубине нашей совести, мы знаем, что должны заботиться об отставших, но мы так счастливы, прорываясь вперед, что мы не успеваем посмотреть, что же происходит в наших новых демократических гетто. 
India, which is both poor and democratic, is a happy exception to this rule.	Индия, будучи одновременно бедной и демократической, является счастливым исключением из этого правила. 
Second, most non-nuclear states were happy enough to live under the security umbrella provided by the superpower nuclear duopoly.	Во-вторых, большинство государств, у которых нет ядерного оружия, были вполне рады жить под зонтиком безопасности, обеспеченным ядерной дуополией супердержав. 
Emotions run high in Iran too, which is happy to return to its familiar role as eternal victim in plots by the Great Powers.	Страсти накаляются и в Иране, который счастлив вернуться к привычному амплуа вечной жертвы происков великих держав. 
The anti-inflation hawks in Frankfurt are not at all happy with Bernanke's aggressive 50 basis point cut and the promise of more to come.	Борцы с инфляцией во Франкфурте совсем не рады агрессивному обещанию Бернэйнка снизить процентные ставки на 50 базовых пунктов, а затем и ещё ниже. 
People need to walk to be happy.	Людям нужно ходить, чтобы быть счастливыми. 
Thailand's national mythology is that it is a happy Buddhist country, a "land of smiles" bound together by compassion and harmony under the benevolent grace and blessings of the Palace and the generosity of big business.	Национальная мифология Таиланда заключается в том, что он является счастливой буддийской страной, "землей улыбок", связанной состраданием и гармонией под великодушным благоволением и благословлением "Дворца" и щедрости бизнеса. 
Marcus Buckingham, a business consultant, made the case that the data showed that women have become less happy over the past 40 years.	Маркус Бакингем, консультант по бизнесу, утверждал, что данные показывают, что женщины стали менее счастливыми за прошедшие 40 лет. 
with wages in Brussels far higher than in Manila, for example, Filipino immigrants are generally happy to do such work.	с заработной платой в Брюсселе намного выше, чем, например, в Маниле, филиппинские иммигранты обычно бывают счастливы взяться за такую работу. 
He would certainly be happy to delay the vote - and, if it is held, to dispute its legitimacy.	Он, конечно, был бы счастлив отложить голосование - и, если его все-таки проведут, оспорить его законность. 
Mubarak apparently surprised them by saying that he knew that many leading people in the country were thieves, but that he believed they had stolen enough to keep them happy.	Мубарак же поразил их, признавшись, что ему известно, что многие из ведущих фигур в стране являются ворами, но что он считает, что они уже наворовали достаточно для счастливой жизни. 
But I am happy that the French Socialists have made a powerful statement on behalf of the Treaty.	Но я рад, что французские социалисты убедительно высказались в пользу договора. 
Industrial countries should be happy that developing countries would take greater responsibility for global economic outcomes, rather than simply sulking about their lack of voice and representation.	Индустриальные страны должны быть довольны тем, что развивающиеся страны будут нести большую ответственность за результаты глобальной экономики, а не только сетовать на недостаточность своего голоса и представительности. 
Treating depression is often, if not always, effective, and without it, those who suffer from depression cannot live happy, fulfilling lives.	Лечение депрессии часто, если ни всегда, бывает эффективным, а без него те, кто страдает депрессией, не могут жить счастливой полноценной жизнью. 
Are we happy to live in a world where the rich can rely on ever more clever technical tricks, while we ignore the right of poor countries and communities to the basic requirements of survival?	Разве мы довольны тем, что живем в мире, в котором богатые могут рассчитывать на более изощренные технические приспособления, пока мы игнорируем право бедных стран и сообществ на основные требования выживания? 
Now that happy union between the Kremlin and ordinary Russians is ending.	Теперь этот счастливый союз между Кремлем и простыми россиянами подходит к концу. 
China, which launched the idea, is happy to see the discussion gaining momentum, but lacks precise ideas.	Китай, который выдвинул эту идею, рад видеть, что дискуссия набирает "обороты", но у него отсутствуют конкретные предложения. 
And Iran and Syria, for their part, have never been too happy with Prime Minister's Recep Tayyip Erdoğan's aspirations to act as a broker in Lebanon, which they consider to be their strategic backyard.	И Иран, и Сирия, по-своему, никогда не были слишком довольны стремлениями премьер-министра Раджипа Тайипа Эрдогана действовать в качестве брокера в Ливане, который они рассматривают как свой стратегический задний двор. 
It applauded the military takeover in Algeria in the early 1990's aimed at curtailing the democratic emergence of an Islamist regime, and is happy to conduct business with authoritarian regimes throughout the Arab world.	Он приветствовал военный переворот в Алжире в начале 1990-х годов, целью которого было помешать демократическому зарождению Исламистского режима, и был рад вести коммерческую деятельность с авторитарными режимами по всему арабскому миру. 
People who claim to be happy tend to live longer, commit suicide and abuse drugs and alcohol less often, get promoted more frequently by their employers, and enjoy more good friends and lasting marriages.	Люди, утверждающие, что они счастливы, живут дольше, не так часто кончают жизнь самоубийством, не злоупотребляют наркотиками и алкоголем, чаще продвигаются по карьерной лестнице работодателями, имеют больше надежных друзей и долгосрочные брачные отношения. 
Yet, no matter how enamored of the "international community" they may be, the Palestinians might not be happy with a plan that comes from a US-led international alliance.	Палестинцы, вне зависимости от того, насколько они могут быть очарованы "международным сообществом", вряд ли будут довольны планом, исходящим от альянса, возглавляемого США. 
Islamism, besides offering them an answer to the question why they do not feel happy with the way they live, gives them a sense of their self-worth and a great cause to die for.	Исламизм, помимо того, что предлагает им ответ на вопрос, почему они не чувствуют себя счастливыми, дает им ощущение собственной значимости и великое дело, за которое можно умереть. 
America isn't happy with Musharraf, either.	Америка также не довольна Мушаррафом. 
The Americans are happy that India's pesky left, reduced to a paltry 24 seats, has been all but eliminated from national government.	Американцы счастливы, что досадных левых Индии, количество которых уменьшилось до ничтожных 24 мест, едва ли не полностью устранили из национального правительства. 
We naively hold our breath waiting for a happy moment when another portion of foreign aid will arrive.	Мы, затаив дыхание, наивно ждем счастливого момента, когда прибудет следующая порция иностранной помощи. 
While the EU cannot hold out the prospect of membership, Russia is happy to offer membership in a reconstituted empire.	И если ЕС не может предложить им членство в союзе, то Россия рада принять их в обновлённую империю. 
I'd be happy to share my travel plans with, say, British Airways if I thought they would give me a good deal.	Я была бы счастлива поделиться своими планами, скажем, с British Airways, если бы была возможность получить от них выгодное предложение. 
As the warm welcome given to Hillary Clinton on her recent swing through Asia - even in communist Vietnam - appears to show, Southeast Asians are more than happy to hang on to Pax Americana for a bit longer, out of fear of China.	Как показывает теплый прием, оказанный Хиллари Клинтон во время ее последнего турне по Азии - даже в коммунистическом Вьетнаме - Юго-Восточная Азия более чем счастлива сохранить Пакс Американа немного дольше из страха перед Китаем. 
The deal was signed and almost everybody was happy:	Сделка состоялась, и все были счастливы: 
They are happy to vote, knowing that everyone else is voting, too.	Они рады принимать участие в выборах, зная, что это делают все. 
Europeans may not mind this right now (one sees more Obama t-shirts in Europe than in the US), but they might not be so happy if a George Bush III comes along.	Возможно, сейчас европейцев это не волнует (маек с изображением Обамы в Европе больше, чем в США), но они едва ли будут так же счастливы, если появится какой-нибудь Джордж Буш III. 
Third, he seems to have been a consistent behind-the-scenes supporter of the Bank, whereas many of his Bush administration colleagues would be just as happy to see it shut down and its Washington headquarters turned into private condominiums and offices.	В-третьих, он всегда оставался негласным сторонником Банка, тогда как многие его коллеги были бы рады его закрытию и превращению его Вашингтонской штаб-квартиры в частный кондоминиум и офисы. 
According to legends, this is where Noah built his ark and Perseus saved the beauty Andromeda, with whom he lived a long and happy life.	По преданиям, именно здесь Ной построил свой ковчег, а Персей спас красавицу Андромеду, с которой здесь же они прожили долгую и счастливую жизнь. 
Not everyone is happy that the Russian authorities are trying to fight the problem by "tightening the screws."	Не все довольны тем, что российские власти пытаются бороться с проблемой путем "закручивания гаек". 
They live among their extended family, are loved, cared for and are happy.	Они живут в большой семье, любимы, окружены заботой и счастливы. 
"You won't be happy here," he told me.	"Здесь ты не будешь счастлива", - сказал он мне. 
Not that everything has to be simplified or come to a happy ending, but that there is an innate sense of good and evil.	Не то чтобы все должно быть упрощено или приводить к счастливой концовке, но необходимо, чтобы было врожденное понимание добра и зла. 
In these villages, free medical care is truly a cause for celebration, and Bwelle - with his big smile and boundless energy - is more than happy to join in the fun.	Бесплатное медицинское обслуживание в этих деревнях действительно является поводом для праздника, и Бвелле с его широкой улыбкой и безграничной энергией более чем счастлив присоединиться к веселью. 
"I am so happy when I am doing this work," Bwelle said.	"Я так счастлив, когда делаю эту работу, - сказал Бвелле. 
Earlier research had revealed that happy dogs wag their tails more to the right (from the dog's point of view), while nervous dogs have a left-dominated swish.	Более ранние исследования показали, что довольные собаки виляют хвостом в правую сторону (с точки зрения собаки), в то время как встревоженные собаки помахивают хвостом преимущественно в левую сторону. 
Last year a team from the University of Lincoln found that dogs turn their heads to the left when looking at an aggressive dog and to the right when looking at a happy dog.	В прошлом году группа ученых из университета Линкольна обнаружила, что собаки поворачивают головы влево, если смотрят на агрессивную собаку, и вправо, если смотрят на довольную собаку. 
We are very happy that our Turkish colleagues and partners at all levels are interested in developing and deepening Belarusian-Turkish relations in all spheres and domains.	Мы очень рады тому, что наши турецкие коллеги и партнеры на всех уровнях заинтересованы в развитии и углублении белорусско-турецких отношений во всех сферах и областях. 
For that reason I am especially happy that my store opened in Moscow.	Поэтому я особенно рад, что у меня открылся магазин в Москве. 
'They are a big happy family now and Alyona and Makhar are both great kids,' said a close friend.	"Они большая счастливая семья теперь, и Алёна и Махар - оба прекрасные дети", говорит близкий друг. 
Of course, I am very happy that I will once again play for Borussia”, Bild cites Kagawa as saying.	Конечно, я очень рад, что вновь буду играть за "Боруссию", - приводит Bild слова Кагавы. 
Of course I am happy that I managed to win at Roland Garros.	Конечно, я рада, что удалось победить на "Ролан Гаррос". 
I'm very happy.	Я очень счастлив. 
I'm so happy for you.	"Я так рад за тебя. 
He was very happy.	Он был очень счастлив. 
Mihaly Czikszentmihalyi asks, "What makes a life worth living?" Noting that money cannot make us happy, he looks to those who find pleasure and lasting satisfaction in activities that bring about a state of "flow."	Mиxaй Чиксентмихайи спрашивает: "Что делает жизнь достойной существования?" Отмечая, что деньги не могут сделать нас счастливыми, он обращает взгляд к тем, кто находит удовольствие и продолжительное удовлетворение в деятельности, которая вызывается состоянием "потока". 
And I realized how few of the grown-ups that I knew were able to withstand the tragedies that the war visited on them - how few of them could even resemble a normal, contented, satisfied, happy life once their job, their home, their security was destroyed by the war.	И я понял, как мало знакомых мне взрослых людей могли выдержать те трагедии, которые обрушились на них в годы войны. Лишь немногие из них могли создать хотя бы подобие той нормальной, довольной, стабильной и счастливой жизни, которая была у них до того как их работа, их дома и их благополучие были разрушены войной. 
But this, for instance, shows that about 30 percent of the people surveyed in the United States since 1956 say that their life is very happy.	Этот график, например, говорит нам о том, что около 30% людей, опрошенных в США с 1956 года, говорят, что у них очень счастливая жизнь. 
So my research has been focused more on - after finding out these things that actually corresponded to my own experience, I tried to understand: where - in everyday life, in our normal experience - do we feel really happy?	Таким образом, в своей дальнейшей работе, после того, как я нашёл подтверждение тому, что уже знал из собственного опыта, я пытался понять, когда, при каких условиях в нашей повседневной жизни мы чувствуем себя по-настоящему счастливыми. 
I'm happy.	Я счастлива. 
Greenpeace was thrilled. The whales were happy. That's a quote.	В Гринписе все взволнованы, Киты-счастливы. Это цитата. 
And actually, Redditors in the Internet community were happy to participate, but they weren't whale lovers.	И даже Reddit-оры в Интернет общности были рады учавтсвовать, хотя и не были фанатами китов. 
But is he happy?	Но счастлив ли он? 
I was really happy.	Я был очень счастлив. 
But there is a happy ending to this story.	Но у этой истории есть счастливый конец. 
And kids starting to make their own books, and a happy kid with the first book that he's ever owned.	Дети начали делать свои книги, и ребёнок счастлив своей первой книге.
Some of these mushrooms are very happy mushrooms.	Некоторые из тех грибов - очень счастливые грибы. 
So we had been there for 20 minutes; we were happy to exit the store.	Итак, мы находились там около 20 минут и были счастливы покинуть магазин. 
I'm not happy with that sentiment at all.	Я совсем рад этому положению. 
And he was so full, he was so happy and so fat eating this seal, that, as I approached him - about 20 feet away - to get this picture, his only defense was to keep eating more seal.	Он был таким толстым, сытым и довольным! Когда я подошёл к нему - где-то на 6 метров, - чтобы сделать это фото, он спокойно продолжал его есть. 
And so I'm just so happy that the dive is over.	Здесь я очень счастлив, что погружение закончено. 
And the one who is happy, even for a slapstick joke, accepts himself and also the scheme of things in which one finds oneself.	И тот, кто счастлив, даже несмотря на насмешки, принимает самого себя как он есть и способен найти свое место в мире. 
That experience confirms that, in spite of all your limitations - all your wants, desires, unfulfilled, and the credit cards and layoffs and, finally, baldness - you can be happy.	Такой опыт подтверждает что, несмотря на все ваши ограничения, ваши желания и устремления, кредиты, увольнения, и даже облысение, вы все же можете быть счастливым. 
But the extension of the logic is that you don't need to fulfill your desire to be happy.	Логически все это подтверждает, что вы не нуждаетесь в исполнении ваших устремлений, чтобы быть счастливым. 
I mean, look how happy the people are, and good-looking too.	Посмотрите, какие это счастливые и милые люди. 
And if people were just trying to be happy, the moment they would get to the top, they would say, "This was a terrible mistake.	А если бы люди старались просто быть счастливы, в момент достижения вершины, они бы сказали: "Это была ужасная ошибка. 
Now at the moment when he was working, he was actually quite happy.	В моменты работы он был по-настоящему счастлив. 
You shred people's efforts, output, you get them not to be as happy with what they're doing.	Вы уничтожаете усилия людей и на выходе вы получаете не самых счастливых от своей работы людей. 
I'm happy, actually, today, to present her.	Я счастлив сегодня представить её. 
We fill our head with distraction, with busyness, so that we don't have to ask, am I well? Am I happy? Are my children growing up right?	Мы забиваем голову разными вещами, отвлекаемся, загружаем себя так, что не приходится спрашивать себя: хорошо ли мне? счастлив ли я? правильно ли я воспитываю детей? 
That's really the main question before us today. Is it possible to slow down? And I'm happy to be able to say to you that the answer is a resounding yes.	Это действительно самый главный вопрос перед нами сегодня. Возможно ли протормозить? И я. я рад сообщить вам, что ответ - твердое ДА! 
And everybody's happy about that.	И все счастливы. 
And they're happy over and over again.	Счастливы снова и снова. 
So I'm happy to get a chance to tell you about it.	Я рад, что мне удалось рассказать вам о ней. 
At the opposite, everyone knows deep within that an act of selfless generosity, if from the distance, without anyone knowing anything about it, we could save a child's life, make someone happy.	С другой стороны, каждый глубоко внутри себя знает, что сделать что-то бескорыстно и великодушно - это может быть незаметно, совсем не надо, чтобы кто-то что-то узнал: спасти жизни ребёнка, сделать кого-то счастливым, 
Everybody goes, I'm happy.	Все согласны, я счастлив. 
One group of monkeys gets an apple, they're pretty happy.	Одной группе обезьян раздали по яблоку, и они очень рады. 
Plenty of play in childhood makes for happy, smart adults - and keeping it up can make us smarter at any age.	Достаток игр в детстве - залог того, что взрослый человек будет разумным и счастливым, а если не прекращать играть, то можно стать умнее в любом возрасте. 
No songs, no "I want" moment, no happy village, no love story.	никаких песен, ничего похожего на мечтания героя, никакой счастливой деревни, никакой истории любви. 
And the fax said, there should be songs, there should be an "I want" song, there should be a happy village song, there should be a love story and there should be a villain.	Там было сказано: "Нужны песни, особенно сокровенные мечтания героя, нужна счастливая деревня и история любви, не обойтись и без злодея. 
And I'm really happy to be here.	Я очень счастлив быть здесь. 
But the truth is that I had a very happy childhood, full of laughter and love, in a very close-knit family.	Но правда в том, что у меня было очень счастливое детство, полное смеха и любви, в очень дружной семье. 
I suspect that the word "atheist" itself contains or remains a stumbling block far out of proportion to what it actually means, and a stumbling block to people who otherwise might be happy to out themselves.	Я подозреваю, что само слово "атеист" является камнем преткновения, далеким от своего истинного значения, и камнем преткновения для людей, которые в противном случае были бы рады заявить о своих взглядах. 
Since we know people want to be happy, maybe when our minds wander, they're going to someplace happier than the place that they're leaving.	Раз уж люди хотят быть счастливыми, может быть, отпустив свои мысли, они переносятся куда-то, где им лучше, чем там, где они физически находятся. 
This graph shows happiness on the vertical axis, and you can see that bar there representing how happy people are when they're focused on the present, when they're not mind-wandering.	На этом графике счастье находится на оси ординат, и столбик, который вы видите на экране, показывает, насколько счастливыми чувствуют себя люди, сосредоточенные на настоящем, не позволяющие себе думать о другом. 
As it turns out, people are substantially less happy when their minds are wandering than when they're not.	Оказывается, люди чувствуют себя гораздо менее счастливыми, когда их мысли блуждают, чем когда они сосредоточены на настоящем. 
Now you might look at this result and say, okay, sure, on average people are less happy when they're mind-wandering, but surely when their minds are straying away from something that wasn't very enjoyable to begin with, at least then mind-wandering should be doing something good for us.	Глядя на результат, вы можете сказать: хорошо, в общем люди менее счастливы, когда их мысли где-то бродят, но скорее всего причина в том, что они мысленно убегают от неприятной ситуации, и таким образом мысленное перенесение хорошо влияет на их самочувствие. 
As it turns out, people are less happy when they're mind-wandering no matter what they're doing.	Оказывается, люди чувствуют себя менее счастливыми, когда думают о другом, вне зависимости от того, что они делают на самом деле. 
Even when they're thinking about something they would describe as pleasant, they're actually just slightly less happy than when they aren't mind-wandering.	И даже когда люди думают о приятных для них вещах, они чуть-чуть менее счастливы, чем когда они остаются в настоящем. 
I was free, I was happy.	Я был свободен, я был счастлив. 
And what I'm so happy about with this is that we have already documented that there are many countries in Asia, in the Middle East, in Latin America and East Europe that [are] reducing with this rate.	И я счастлив, что мы уже фиксируем, что многие страны в Азии, на Ближнем Востоке, в Латинской Америке и в Восточной Европе снижают этот показатель. 
I was so happy.	Я был так счастлив. 
So ladies and gentlemen, I'm very happy to announce, this gift of the 21st century to the world from India, Gandhian engineering.	Итак, леди и джентльмены, рад вам сообщить, что подарок 21-го века миру от Индии - Ганди инжиниринг. 
And then for the consumers, for everyone else in the audience, let me simply summarize it by saying, increasingly, what we - what will make us happy, is spending our time and our money satisfying the desire for authenticity.	И теперь для потребителей и всех, кто находится в этом зале, позвольме мне резюмировать просто сказав, что мы - или что делает нас счастливыми, это когда мы тратим свои деньги и время в поисках удовлетворения своего желания получить аутентичное впечатление. 
And it's not because people were happy or people were not frustrated.	И не потому что люди были счастливы или просто равнодушны. 
They are happy. They don't have problems.	Счастливы, никаких проблем. 
Because Steven, despite the fact that he was paralyzed, as he was in that pool, he could not walk, he could not use his arms - that's why he had the little floaty things on them, did you see those? - he was happy. We were at the beach, he was raising his son, and he was productive.	Потому что Стивен, несмотря на то, что он был парализован в период, к которому относятся те кадры в бассейне, он не мог ходить, не мог пользоваться руками, поэтому у него на руках эти надувные штуки. Вы видели? Он был счастлив. Мы ходили на пляж. Он растил своего сына. Он вел продуктивную жизнь. 
And what I found in my research and my teaching is that these students, no matter how happy they were with their original success of getting into the school, two weeks later their brains were focused, not on the privilege of being there, nor on their philosophy or their physics.	И, наблюдая за ними, я увидел, что независимо от того, насколько они были рады своему поступлению, через 2 недели они уже думали не об оказанной им чести, не о философии или физике, 
And into the silence, I said, "I'd be happy to speak at your school, but just so you know, that's not a wellness week, that's a sickness week.	И я сказал: "Я буду рад выступить в вашей школе, но у вас вместо недели здоровья получается неделя болезни. 
I don't think I've ever felt so happy in my entire life.	Не думаю, что когда-либо я была счастливее за всю мою жизнь. 
For so much of my life, I wanted something else to make me happy.	Так много раз я хотела, чтобы кто-то сделал меня счастливой. 
I thought if I had the right house or the right car or the right man in my life, then I could be happy.	Мне казалось, что если у меня будет правильный дом или правильная машина или правильный мужчина рядом, я могу стать счастливой. 
I plan on being around for a long time, and when I'm 90 years old, I want to be happy and healthy.	я планирую заниматься всем этим довольно долго, и когда мне стукнет 90, я хочу быть счастливой и здоровой. 
And it's very difficult to be happy on a planet that's racked with famine and drought.	Но очень сложно быть счастливой на планете, страдающей от голода и засухи. 
We're going to talk - my - a new lecture, just for TED - and I'm going show you some illusions that we've created for TED, and I'm going to try to relate this to happiness. What I was thinking about with happiness is, what gives happiness - or happiness, which I equate with joy in my particular area, and I think there's something very fundamental. And I was thinking about this. And it's in terms of both illusions and movies that we go see and jokes and magic shows is that there's something about these things where our expectations are violated in some sort of pleasing way. You go see a movie. And it has an unexpected twist - something that you didn't expect - and you find a joyful experience. You look at those sort of illusions in my book and it's not as what you'd expect. And there's something joyful about it. And it's the same thing with jokes and all these sorts of things. So, what I'm going to try and do in my lecture is go a little bit further and see if I can violate your expectations in a pleasing way. I mean, sometimes expectations that are violated are not pleasant, but I'm going to try to do it in a pleasant way, in a very primal way, so I can make the audience here happy.	Мы поговорим - это моя новая лекция специально для TED. Я покажу вам несколько иллюзий, которые мы создали для TED, и я попробую связать их с ощущением счастья. Мои размышления о том, что такое счастье, что делает нас счастливыми, или счастье, которое я приравниваю удовольствию, если говорить о моей конкретной области, и я думаю, тут есть что-то существенное. Я размышлял об этом. И что касается иллюзий и фильмов, которые мы смотрим, шуток и магических представлений, есть в них что-то такое, что обманывает наши ожидания, но каким-то доставляющим удовольствие способом. Вы идете в кино. Неожиданный поворот сюжета - что-то, чего вы не ожидали, - и вы получаете удовольствие. Вы смотрите на иллюзии в моей книге, и это не то, что вы ожидали. И появляется радость от этого. То же самое с шутками и другими подобными вещами. Поэтому то, что я собираюсь сделать в своей лекции, это пойти немного дальше и проверить, смогу ли я обмануть ваши ожидания и доставить удовольствие. Я имею в виду, что иногда обманутые ожидания неприятны, но я постараюсь сделать их приятными, очень простыми, так, чтобы вам понравилось. 
I'd be happy to show you lots of things.	Я буду счастлив показать вам много интересного. 
I'm not afraid to do what makes me happy.	Я не боюсь заниматься тем, что делает меня счастливее. 
Well maybe the reason that money doesn't make us happy is that we're always spending it on the wrong things, and in particular, that we're always spending it on ourselves.	Может быть, деньги не делают нас счастливыми, потому что мы всё время находим им неправильное применение - мы всё время тратим их на себя. 
We asked them how happy they were, and then we gave them an envelope.	Мы спросили у них, насколько они счастливы, а потом вручили им конверт. 
We called them up at night and asked them, "What'd you spend it on, and how happy do you feel now?"	Вечером мы всех обзвонили и спросили: "На что вы потратили ваши деньги и насколько вы сейчас счастливы?" 
It didn't make them less happy, it just didn't do much for them.	Они не стали менее счастливы. На них это просто никак не повлияло. 
How happy did it make you?"	Насколько счастливы вы стали?" 
And then we asked them how happy they are again.	А потом мы опять спросили насколько счастливыми они себя ощущают.
What we see again though is that the specific way that you spend on other people isn't nearly as important as the fact that you spend on other people in order to make yourself happy, which is really quite important.	Мы опять видим, что то, как вы тратите деньги на других людей, значительно менее важно, чем тот факт, что вы их тратите на других, чтобы самим стать счастливее. Это особенно важно. 
So you don't have to do amazing things with your money to make yourself happy.	Не нужно делать с деньгами ничего необычного, чтобы быть счастливее. 
and they ask them, "How happy are you with your life in general?"	а затем: "Насколько вы счастливы в жизни?" 
Giving money makes you happy.	Отдавая деньги, становишься счастливее. 
And, as I stood there, looking at the happy lamb that I had just defiled - but it looked OK.	Я стою там и смотрю на счастливого ягнёнка, которого я только что "осквернил", но он был в порядке. 
And here he is six years later, Guinness, with his very happy owner.	А вот уже шестью годами позже, Гиннес со своим счастливым хозяином. 
I'm very happy to be here in India.	Я очень рада быть здесь, в Индии. 
What if you could take a little concoction of pharmaceuticals that would make you feel really contented, just happy to be you.	Что если бы вы могли взять немного фармацевтического зелья, которое могло бы заставить вас почувствовать действительно наполненным, просто счастливым быть самим собой. 
I'm so happy to be here.	Я так счастлива быть здесь. 
I mean, honestly, I'd be happy enough if I can actually get my two dimension correct in school.	Честно, я была бы счастлива, если бы правильно получила два аспекта в школе. 
A lot of people are very happy with Facebook.	Многие люди очень довольны Facebook. 
So the first one - the most famous appointment dynamic in the world - is something called happy hour.	Итак, первая, самая известная динамика предписания в мире - это то, что мы называем "счастливым часом". 
So I just recently dropped out of Princeton and actually ended up for the first time in a bar, and I saw these happy hour things all over the place, right.	Вот я совсем недавно ушёл из Принстона, и впервые оказался в баре, и повсюду заметил эти "счастливые часы". 
I'd be happy to participate in one.	Я был бы счастлив поучаствовать в этом. 
Happy to take a paternity test, and would love to see it happen.	Я буду счастлив пройти тест на определение отцовства и буду рад увидеть, что из этого выйдет. 
But I'm happy to participate in one.	Но я буду рад в нем поучаствовать. 
So it's kind of like you having a job in Chicago, and then you get transferred to St. Louis, and your mate is not happy about this because you've got to pay airfare, because you're gone longer.	Это как если бы у вас была работа в Чикаго, а после неё нужно было бы лететь домой в Сент-Луис. Ваш супруг, наверняка, был бы не слишком этому рад, потому что приходилось бы платить за авиабилеты и долгое время быть в разлуке. 
And they don't just guess what makes people happy; they go to places like Latin America and they realize that happiness there is associated with family life.	И они не просто гадают, что делает людей счастливыми, они отправляются в такие места, как Латинская Америка, и ясно видят, что там счастье ассоциируется с семьей. 
And I'm happy to say only one other person in that area got polio.	И я рада сообщить, что лишь один человек после этого заболел полиомиелитом. 
Now to the ridicule of my colleagues, I inspired my lab to focus on what I thought was the most non-controversial source of stem cells, adipose tissue, or fat, yes fat - nowadays available in abundant supply - you and I, I think, would be very happy to get rid of anyway.	Несмотря на насмешки моих коллег, я вдохновила свою лабораторию на исследования того, что мне кажется наименее сомнительным источником стволовых клеток, а именно жировой ткани. Да-да, жира! Жир сегодня доступен в огромных количествах, я думаю, мы с вами были бы рады избавиться от него. 
We are very happy to have the possibility to be with you in the other side of the world.	Мы счастливы, что у нас есть возможность быть сегодня с вами на другом конце света. 
We are very happy because we have the opportunity to have this angel in the world - not only in our country, Venezuela, but in our world.	Мы очень рады, потому что нам повезло - в мире есть этот ангел. Не только в нашей стране, в Венесуэле. А в мире. 
The beauty of this research though is that no one is suggesting that women have to be thin to be happy;	Прелесть этого исследования в том, что никто не говорит, что женщина должна быть худой, чтобы быть счастливой. 
For example, the happy wife.	Например, счастливая жена вместо того, 
The data were based entirely on whether people looked happy in these early pictures.	Данные полностью основаны на том, выглядят ли люди счастливыми на своих детских снимках. 
But still, I have a huge pile of fake happy childhood pictures and I'm glad they make me less likely than some people to get a divorce.	Но тем не менее, у меня есть огромная пачка таких фальшивых счастливых детских фотографий. И я рада, что благодаря им, у меня меньше шансов на развод, чем у других людей. 
On the other hand, I have the fake happy picture thing.	С другой стороны, у меня есть те фальшивые счастливые фотографии. 
And then the children would get plenty of support, and nurturing, and mentoring, and the world population would decline very rapidly and everybody would be totally happy.	И тогда детям с избытком достанется и поддержки, и заботы, и воспитания, а количество народонаселения станет резко уменьшаться, и все будут бесконечно счастливы. 
They were happy. They had their plans.	Они были довольны жизнью, строили планы. 
Happy to be here.	Рад поучаствовать. 
Now compassion, when it enters the news, too often comes in the form of feel-good feature pieces or sidebars about heroic people you could never be like or happy endings or examples of self-sacrifice that would seem to be too good to be true most of the time.	Когда слово сострадание появляется в новостях, оно часто приходит в виде положительных репортажей или кратких рассказах о героях, до высот которых вы никогда не поднимитесь, или историях со счастливым концом, или таких примерах самопожертвования, в которые чаще всего трудно поверить. 
And she's pretty happy.	Она очень счастлива. 
You will know what this person is doing, whether happy, sad, old, young - a huge amount of information.	Вы будете знать, что этот человек делает, будь он счастлив, печален, стар, молод - огромное количество информации. 
I meet people all the time who have those, and they're not necessarily happy.	Я постоянно встречаю людей, у которых это есть, и они не обязательно счастливы. 
If money actually made you happy, then the wealthiest people in the world would be the happiest.	Если бы деньги на самом деле делали тебя счастливым, тогда самые богатые люди в этом мире были бы самыми счастливыми. 
We're so happy to see you, little bottle."	Мы так рады видеть тебя, маленькая бутылочка". 
And now the dog's really happy.	И теперь собака по-настоящему счастлива. 
And what struck me immediately in meeting Hyun-Sook was how confident she appeared to be, how happy she seemed to be in her own skin.	И меня сразу поразило при встрече с Хьюн Сук, насколько она была уверена в себе и насколько счастлива быть самой собой. 
I sort of had this picture of this incredibly wonderful, bright, happy little child, who now appeared to be very withdrawn, being enslaved by this family.	Я-то все еще помнил этого замечательного, светлого, счастливого ребенка, который полностью замкнулся, порабощенный этой семьей. 
I made a promise to her grandmother, your mother, that I would find a family, and now I'm so happy that you're going to take care of her."	Я пообещал ее бабушке, вашей маме, что я найду для нее семью, и я очень рад, что вы о ней позаботитесь." 
The small planets dominated, and there was a certain harmony to that, which actually Copernicus was very happy to note, and Kepler was one of the big proponents of.	Маленькие планеты доминировали, и в этом была определённая гармония о которой Коперник был очень рад упомянуть, и Кеплер был одним из больших сторонников этого. 
And we are very happy to be part of the TED family.	И мы очень счастливы быть частью семьи TED. 
I was really happy when I was done.	Был очень рад, когда все закончилось. 
It's an incredibly non-materialistic culture, where people don't have a lot, but they're incredibly happy.	Это общество абсолютно не материалистично, где у людей нет многого, но они необыкновенно счастливы. 
So, you have some really happy person holding 10 balloons, and some really sad soul holding one balloon.	В итоге, находятся очень счастливые люди с десятью шарами и некоторые печальные с одним шаром. 
But you know, even holding one balloon is like, kind of happy.	Но вы понимаете, даже имея один шар, человек немного счастлив. 
And then I would ask them a number of questions like what was the happiest day in their life, what makes them happy.	Затем я задавал ряд вопрос как, например, какой был самый счастливый день их жизни и что делает их счастливыми. 
I also used to think that all of our food came from these happy, little farms where pigs rolled in mud and cows grazed on grass all day.	Я тоже думал, что вся еда приходит из этих счастливых, маленьких ферм, где свинки валяются в грязи, а коровы пасутся на зеленой траве весь день. 
Graphic designer Stefan Sagmeister takes the audience on a whimsical journey through moments of his life that made him happy - and notes how many of these moments have to do with good design.	Графический дизайнер Стефан Загмайстер отправляется с аудиторией в фантастическое путешествие по моментам своей жизни, сделавшим его счастливым - и отмечает те моменты счастья, которые зависели от хорошего дизайна. 
There's one from a consumer's point of view - where I was happy while experiencing design.	Первое - с точки зрения потребителя, то есть когда я был счастлив, используя стильные предметы. 
Now, there is the other part, from a designer's standpoint - if you're happy while actually doing it.	Теперь посмотрим с другой стороны, со стороны дизайнера - - если ты счастлив, когда создаешь. 
And one way to see how happy designers are when they're designing could be to look at the authors' photos on the back of their monographs?	И один из способов узнать, насколько дизайнеры могут быть счастливы, - это посмотреть на фотографии авторов на обратной стороне их монографий. 
So, according to this, the Australians and the Japanese as well as the Mexicans are very happy.	Дэвид Ланкэшир Похоже, что самые счастливые дизайнеры - австралийские и японские, а также мексиканские - они очень счастливы. 
A happy dog - and you take it out, it's an aggressive dog.	Вот счастливая собака, снимаем и получаем агрессивную собаку. 
It's a happy David Byrne and an angry David Byrne.	Вот счастливый Дэвид Бирн, а вот очень злой Дэвид Бирн. 
Or a jazz poster with a happy face and a more aggressive face.	Вот джазовая афиша со счастливым и с более агрессивным лицом. 
I would definitely say that observing Vik Muniz' "Cloud" a couple of years ago in Manhattan for sure made me happy, as well.	Определенно могу сказать, что наблюдение за работой Вика Мунца "Облака" пару лет назад сделало меня также счастливым. 
And, of course, happy faces.	И, конечно же, счастливые лица. 
You can see the happy face on Mars, there.	Вот, на Марсе тоже существует счастливое лицо. 
And they tell us that even if we do it by astrology, theyв ™re happy.	Они говорят нам: даже если вы используете астрологию, мы счастливы.
And we were very, very happy.	И мы были невероятно счастливы. 
And it seemed on the road to some sort of a decent life - a happy ending to a story involving wise improvisation from a wise judge.	И уже казалось, что это дорога к достойной жизни и счастливый конец истории про мудрую импровизацию мудрой судьи. 
There's now a lot of research being done in psychology on what makes people happy, and the two things that jump out in study after study - I know this will come as a shock to all of you - the two things that matter most to happiness are love and work.	Существует много психологических исследований о том, что делает людей счастливыми, и два фактора возникают практически в каждом исследовании - я знаю, что вас всех это шокирует - два фактора, наиболее важные для счастья, - это любовь и работа. 
But if I show you this picture it's not to tell you how happy we were.	Но я показываю вам эту картинку не для того, чтобы передать, как счастливы мы были, 
He said, "Be happy.	Он сказал: "Будьте счастливы. 
A happy patient is a healthy patient."	Счастливый пациент это здоровый пациент". 
And everybody was really happy for me, but me.	И всё были по-настоящему рады кроме меня. 
And this woman is very happy now, bringing her products to the market.	Женщина на фото рада, что везет продукты на рынок. 
And, it would arrive at an agreement that everybody was happy with, without having to manipulate them so much - which is basically what I do, I manipulate them.	И приходили бы к согласию, в котором все были бы счастливы, без лишних манипуляций - которые в основном я делаю, я манипулирую ими. 
It's like they feel "happy, happy, excited, oh shit, frustrated, frustrated, overwhelmed, depressed."	Они чувствую себя примерно так "счастлив, счастлив, радостно взволнован, о черт, недоволен, недоволен, потрясен, подавлен". 
Or, no matter what happens, they find a way to be happy or excited.	Или, независимо от обстоятельств, они находят способ быть счастливыми или радостными. 
I felt very happy to be at the secondary school, so I was determined to do anything possible to receive education.	Я был так счастлив ходить в школу. Поэтому я решил сделать всё возможное, чтобы получить обучение. 
And Jill and Kevin, the happy couple, they came back from their honeymoon and found that their video had gone crazy viral.	Счастливые молодожёны, Джилл и Кевин, вернулись из свадебного путешествия и узнали, что их видео распространяется подобно эпидемии. 
The color of each particle corresponds to the type of feeling inside - so that happy, positive feelings are brightly colored.	Цвет каждой частицы соответствует определенному типу чувств внутри - так что счастливые, позитивные чувства ярко окрашены. 
One of the things that I'm really, really happy to be able to show you here today is our virtual autopsy table.	Предмет моей особенной гордости, который я счастлив представить вам сегодня, - это наш стол для виртуальной аутопсии. 
The customer is happy, because the customer is God.	Клиент счастлив, потому что клиент - это Бог. 
I'm really happy that Mr. Anderson invited me.	Я очень рада, что мистер Андерсон меня пригласил. 
And I'm very happy to report that we're now using a dose of radiation that is equivalent to the effective dose from one digital mammogram.	И я очень счастлива скзать, что сейчас мы используем дозы радиации, которые эквивалентны эффективной дозе одной цифровой маммограммы. 
You'll be happy to know that I'll be talking not about my own tragedy, but other people's tragedy.	Вы будете рады узнать, что я расскажу вам не о своей трагедии, а о трагедии других людей. 
But ultimately, the story has a happy ending for Sudhir, who became one of the most respected sociologists in the country.	Но у этой истории счастливый конец для Судира, который стал одним из самых уважаемых социологов в стране. 
And of course, I'm very happy you asked that question - - because that's a very good question.	И, конечно, я очень рад, что вы задали этот вопрос потому что это очень хороший вопрос. 
That if you live in the best climate, in San Diego in the United States, or in the shittiest climate, in Buffalo, New York, you are going to be just as happy in either place.	То есть, живете ли вы в лучшем климате, в Сан-Диего в Соединённых Штатах, или в дерьмовейшем, в Буффало, штат Нью-Йорк, вы будете одинаково счастливы в обоих местах. 
Black people are just as happy as white people are.	Негры так же счастливы, как и белые. 
If I make this whole thing a little bit more personal and see what makes me happy as a designer, the easiest answer, of course, is do more of the stuff that I like to do and much less of the stuff that I don't like to do - for which it would be helpful to know what it is that I actually do like to do.	Если я сделаю всё это чуть более личным и посмотрю, что делает счастливее меня, как дизайнера, конечно, самый лёгкий ответ - делать больше того, что я люблю делать, и меньше того, что я делать не люблю - а для этого неплохо знать, что же я на самом деле люблю делать. 
But as I was traveling here, you'll be very happy to know, I did use my white symbol stick cane, because it's really good to skip queues in the airport.	Но когда я ехала сюда, вы будете рады услышать, что я все-таки воспользовалась своей белой тростью, потому что с ней можно проходить без очереди в аэропорту. 
TD: So, even though I'm somewhat happy about the wonderful developments that are happening in the world, still, I feel a sense of impediment, when it comes to the ability that we have to connect with each other on a heart-to-heart, or a mind-to-mind, level.	То есть хотя я в какой-то мере счастлив, наблюдая за замечательным развитием мира, тем не менее, я чувствую некие трудности на пути нашей способности соединяться друг с другом сердцем или разумом. 
I'm happy."	Я счастлив". 
It was a very happy ending.	Получился очень счастливый конец. 
And I'm happy to say that I'm now in the process of setting up this technology here in India.	Я рада сообщить, что сейчас я разворачиваю эту технологию здесь, в Индии. 
But we're really, really happy about who they are.	Мы просто очень-очень рады, что они такие, какие есть. 
This is why spouses in happy marriages tend to think that their husband or wife looks much better than anyone else thinks that they do.	Вот почему супруги в счастливых браках видят своего мужа или жену более красивыми, чем могли бы подумать другие. 
But there's at least one case where Capgras syndrome had a happy ending.	Однако есть как минимум один случай, когда синдром Капгра закончился счастливо. 
After she got it, "She was happy to report that she has discovered that he possessed a double who was rich, virile, handsome and aristocratic."	После: "Она была счастлива доложить, что она обнаружила его двойника, который был богатым, сексуальным, мужественным и аристократическим". 
The "dismal science" truly shines in this optimistic talk, as economist Alex Tabarrok argues free trade and globalization are shaping our once-divided world into a community of idea-sharing more healthy, happy and prosperous than anyone's predictions.	"Mpaчнaя наука" особенно сияет в этой оптимистичной лекции. Экономист Алекс Табаррок утверждает, что свободная торговля и глобализация создают на месте нашего когда-то разделенного мира общество обмена идеями, здоровее, счастливее и богаче чем кто-либо мог представить. 
Come on, they live in big houses, they have big cars, they all have blond hair, blue eyes, they're happy.	Да что вы, не знаете что ли, они живут в больших домах, ездят на больших машинах, у них у всех светлые волосы, голубые глаза, они счастливы. 
Just please accept that this piece of you escapes with your smile, and those of us who notice are happy to catch it in passing.	Просто признайтесь, что эта Ваша частичка проявляется, когда Вы улыбаетесь, и те из нас, кто знают о ней, рады отметить её мимолётом. 
They were happy because the story survived, and that the world would keep on spinning.	Они были счастливы, ведь история продолжилась, и мир не рухнул. 
I have much to make me happy and relieved.	У меня есть достаточно, чтобы я мог быть счастлив и свободен. 
They became so hilarious, but I was happy for them.	Они были так веселы, но я была счастлива за них. 
We are only happy when things are in order.	Мы счастливы только когда есть порядок. 
And I'm happy to sign it for you with any name of any artist.	И я буду счастлив подписаться в ней именем любого художника. 
Now the good news here is that if you take surveys from around the world, we see that about three quarters of people will say they are at least pretty happy.	Есть и изменения в лучшую сторону. В целом ряде стран опросы показывают, что почти три четверти людей что они по крайней мере "вполне счастливы". 
He said, "One feels inclined to say that the intention that man should be happy is not included in the plan of creation."	По его словам, "задача сделать человека счастливым не входила в план сотворения мира". 
Because, for example, the genes don't care whether we're happy, they care that we replicate, that we pass our genes on.	Скажем, нашим генам неважно, счастливы мы или нет. Их интерес в том, чтобы мы продолжали род и передавали гены далее. 
Yes, my mom was happy about that last one.	Да, моя мама была счастлива по поводу последнего. 
If I do something that makes you happy, I get to share your joy.	Если я сделал что-то, что делает вас счастливыми, я могу разделить вашу радость. 
So there's a picture of Francis and I before I met the girl, so I'm still looking happy.	Вот я и Фрэнсис на фото. Я пока ещё не был знаком с девушкой, и выглядел счастливым. 
And so I didn't really get happy until 1960, because then we found out, basically, you know, that there are three forms of RNA.	Я не был по-настоящему счастлив вплоть до 1960 года, когда мы наконец обнаружили, что есть три типа РНК. 
Well, they were happy as could be, because he hadn't said a rational word in the weeks of observation.	И все были счастливы до крайности, потому что до того он неделями не произносил ничего осмысленного. 
But it's been very exciting. It's been very happy.	Это время было очень захватывающим, очень счастливым. 
When I have a mother of an autistic child say, "My kid went to college because of your book, or one of your lectures," that makes me happy.	Когда мать ребенка-аутиста говорит мне: "Мой ребенок поступил в колледже благодаря Вашей книге или одной из Ваших лекций" - это делает меня счастливой. 
They wanted it messy, and we were happy to oblige.	Они хотели беспорядка, а мы были только рады подчиниться. 
And when I met Harriet in person the next year at the TED Conference, she'd gone online and ordered our own happy Haplotype T-shirts.	Когда год спустя я лично познакомился с Хэрриет на конференции TED, она через интернет заказала для нас, счастливых обладателей редкого гаплотипа, тематические футболки. 
So we had one group that I hoped their performance would be very high, another group that I thought their performance would be very low, and when I got the results, that's what we got - I was very happy - aside from one person.	У нас была одна группа, на высокие показатели которой я надеялся, и другая, у которой я ожидал низкие показатели. Когда я получил результаты, вот что мы получили - я был очень доволен - кроме одного человека. 
And for the past 23 years, at an increasing rate, we've been pouring more and more ideas and capabilities and so on into Mathematica, and I'm happy to say that that's led to many good things in R & D and education, lots of other areas.	В течение последних 23 лет мы обогащали пакет Mathematica новыми идеями и возможностями во всё возрастающем темпе, и я рад сообщить, что это помогло создать много полезного в научных исследованиях, образовании и многих других областях. 
But I'm happy to say it's actually going really well.	Но я рад сообщить, что проект продвигается весьма успешно, 
And the monkeys in that monkey forest looked, actually, fairly happy.	И обезьяны из этого обезьяньего леса выглядели вполне себе счастливыми. 
And I'm happy I'm alive.	"И я счастлив, что я жив. 
I'm happy I'm alive.	Я счастлив, что я жив. 
And they're not happy with this.	И они не счастливы от этого. 
I might write about a Muslim woman in one novel, and perhaps it will be a very happy story, and in my next book, I might write about a handsome, gay professor in Norway.	Я могу написать о мусульманской женщине в одном романе. И возможно это будет очень счастливая история. А в следующей книге, я могу написать о красивом профессоре-гее из Норвегии. 
Because the best stories always have a happy ending.	Ведь у лучших историй всегда счастливый конец. 
And I wrote a lot of happy songs on my first record, which I still stand by, but this has got something else in it.	Я записал много счастливых песен на моей первой пластинке, которых я до сих пор придерживаюсь, но эта получилась другой. 
Because there happy to be doing something that's the right thing to do.	Потому что они рады делать что-то, что правильно. 
People were happy.	Люди были счастливы. 
And the people were happy. They were satisfied.	И люди были счастливы, они были довольны. 
And let me tell you right now, it's fine that we would all be very happy with speech.	Позвольте сказать вам, естественно, мы были бы очень счастливы слышать речь. 
I am very, very happy to be amidst some of the most - the lights are really disturbing my eyes and they're reflecting on my glasses.	Я очень, очень рад быть среди одних из самых - свет от ламп действительно режет мне глаза и отражается в моих очках. 
I am very happy and honored to be amidst very, very innovative and intelligent people.	Я очень счастлив и это большая честь для меня быть среди таких новаторов и интеллектуалов. 
About 120 interventions have been proposed that allegedly make people happy.	Мы составили список из примерно 120 способов воздействия, претендующих на способность сделать человека счастливым, 
And I believe there are three different - and I call them different because different interventions build them, it's possible to have one rather than the other - three different happy lives.	разумную постановку вопроса. Я считаю, что есть три различных вида - я говорю "различных", потому что они вызываются различными видами воздействия, и вполне допустимо иметь один, но не другой - есть три различных вида счастливой жизни. 
I thought, when I first became a therapist 30 years ago, that if I was good enough to make someone not depressed, not anxious, not angry, that I'd make them happy.	Когда 30 лет назад я начал заниматься терапией, я считал, что исцелив человека от депрессии, тревожности, раздражённости, я сделаю его счастливым. Но так никогда не получалось. 
They are now happy sending the news that they have protected the Okapi with the war, because we sent the news that they are killing and poaching everywhere.	Теперь они счастливы и отправляют сообщения, что это они спасли окапи от войны. Потому что мы отправляли сообщения о том, что они убивали и занимались браконьерством везде. 
Everybody is happy, but see what it's doing, see what is going in Darfur.	Все счастливы, но посмотрите, что происходит. Видите, что происходит в Дарфуре. 
And when customers call for service and they're dealing with happy people that can make decisions and are fulfilled, how do the customers feel?	И когда клиенты обращаются в эту компанию, и имеют дело с счастливыми людьми, способными принимать решения и довольными жизнью, как чувствуют себя клиенты? 
When I got there, we had zero happy customers.	Когда я туда пришел, там был ноль счастливых клиентов. 
I care that your customer and your team is happy and you're organized with that.	Мне важно, чтобы ваши клиенты и сотрудники были счастливы и были организованы соответственно. 
Through promoting fun and a great environment, we were able to transform Sciant and, in just three short years - sounds like a long time, but change is slow - every customer, from zero to every customer referring us, above average profits for the industry and happy stakeholders.	И благодаря новому интересному и радостному окружению, нам удалось преобразовать Sciant, и через три года - кажется, это очень долго, но перемены идут медленно, мы пришли к тому, что не ноль, а каждый клиент нас рекомендовал, что наша прибыль была больше, чем в среднем в этой индустрии, и у нас были довольные пайщики. 
And you can say, "Well how do you know they're happy?"	Можно спросить: "А как вы знаете, что они были довольны?" 
And there are all these animals, and all these people happy, and there's this economic value.	Аплодисменты. И там обитают все эти животные, живут все эти довольные люди и существует экономическая выгода. 
And since I don't like to travel alone, they also invited my daughter, son-in-law and granddaughter, so we had a lovely trip to see Russia today, which is not a very pleasant and happy view.	А так как я не люблю путешествовать одна, они также пригласили мою дочь, зятя и внучку. Таким образом, у нас была прекрасная поездка, и мы увидели сегодняшнюю Россию, у которой не очень приятный и не очень счастливый вид. 
We commuted longer to work, but as you can see from this graph, the longer you commute the less happy you're likely to be.	Мы теперь дольше добираемся на работу, но как вы можете видеть из этого графика, чем дольше вы добираетесь до работы, тем менее счастливы вы, вероятно, будете. 
So I'm just going to show you one bottom-line experiment that answers this, and of course I've got a lot of other data, so if you're interested I'm happy to show more. So the experiment is called a reconstruction experiment.	Сейчас я покажу вам один окончательный эксперимент, который отвечает на эти вопросы. Конечно, у меня есть и другая информация, так что если вам интересно, я рада буду её показать. Этот эксперимент называется реконструкцией. 
It pairs closely with love, which is the will for the other to be happy, which requires, of course, that one feels some happiness oneself and wishes to share it.	Это сродни любви. Любовь - желание сделать "другого" счастливым. Это, в свою очередь, предполагает, что любящий сам должен испытывать чувство счастья, которым он хочет поделиться. 
This is perfect in that it clearly opposes self-centeredness and selfishness to compassion, the concern for others, and, further, it indicates that those caught in the cycle of self-concern suffer helplessly, while the compassionate are more free and, implicitly, more happy.	Здесь предельно противопоставлены эгоистичность и себялюбие сочувствию и заботе о других, и, как следствие, это означает, что те, кто находятся в плену своих интересов, безнадежно подвержены страданию, в то время как сочувствие делает людей более свободными и, тем самым, более счастливыми. 
So as he comes up from his first bow he says, "My Lord, I'm so happy to see you, but where have you been for 12 years?	И, как только он завершает свой первый поклон, он говорит: Мой Господин, я так счастлив видеть тебя, но где ты был 12 лет? 
And then you think of how lovely beings are when they are happy, when they are satisfied.	А потом вы думаете, как прекрасны существа, когда они счастливы, когда они удовлетворены. 
When they're angry, they look ugly, every being, but when they're happy they look beautiful.	Когда они рассержены, они неприглядны, каждое существо, но когда они счастливы - они красивы. 
If your enemy was really happy, why would they bother to be your enemy?	А если бы ваш враг был бы счастлив, зачем бы он стал утруждать себя быть вашим врагом? 
And then, finally, that leads to a new orientation in life where we live equally for ourselves and for others and we are joyful and happy.	И тогда, наконец, это приведет к новой ориентации в жизни, когда живешь в одинаковой степени как для себя, так и для других. И мы понимаем это счастье для нас - и мы рады и счастливы. 
Compassion makes you happy.	Сочувствие делает нас счастливыми. 
The first person who is happy when you get great compassion is yourself, even if you haven't done anything yet for anybody else.	Первый, кто становится счастлив от того, что в вас есть сочувствие, это - вы сами, даже если вы еще ничего ни для кого не сделали. 
But, in fact, if you have cell phones, you can now go to this nice lady who's somewhere like Namibia, and who is extremely happy with the fact that although she does not have an master's degree in electrical engineering from MIT, she's nonetheless able to hack her cell phone to get power in some funny way.	Но, на самом деле, если у вас есть сотовый телефон, вы можете подойти к вот такой милой даме, живущей в стране вроде Намибии, которая чрезвычайно рада, что хотя она не получила ученой степени по электронной инженерии в Массачусетском Технологическом Институте, она все же может разломать свой сотовый телефон и получить энергию очень забавным способом. 
I wanted to save the world and then make everyone happy.	Я хотел спасти мир и сделать всех счастливыми. 
It turned out the cell that we were trying to transplant into had a nuclease, an enzyme that chews up DNA on its surface, and was happy to eat the synthetic DNA that we gave it and never got transplantations.	Оказалось, что клетка, внутрь которой мы пытались трансплантировать, имела нуклеазу, фермент, который поглощает ДНК с поверхности, и тот был рад съесть синтетическую ДНК, которую мы поставляли, вот мы и не могли добиться трансплантации. 
And they were really happy that the guy had a speakerphone because then they had to wait on hold for an hour to talk to somebody to give them an access code after they got there.	Они были счастливы, что у хозяина дома был телефон с громкой связью, потому что им пришлось ждать на линии около часа, пока на том конце провода им назовут код доступа для активации модема. 
I love doing this work, because it really gives many people new hope and new choices that they didnв ™t have before, and it allows us to talk about things that - not just diet, but that happiness is not - we're talking about the pursuit of happiness, but when you really look at all the spiritual traditions, what Aldous Huxley called the "perennial wisdom," when you get past the named and forms and rituals that really divide people, itв ™s really about - our nature is to be happy; our nature is to be peaceful, our nature is to be healthy.	Мне нравится эта работа, потому что она действительно дает многим людям новую надежду и новые выборы, которых у них не было, и позволяет нам говорить, что - не только диета, но и что счастье - это не погоня за ним; когда вы всерьез взглянете на духовные традиции, то, что Альдос Хаксли назвал "вечная мудрость", когда вы пройдете через имена, образы и ритуалы, которые разобщают людей, все это о том, что наша природа - быть счастливыми; наша природа - быть спокойными и здоровыми. 
Theyв ™re powerful tools for transformation, for quieting down our mind and bodies to allow us to experience what it feels like to be happy, to be peaceful, to be joyful and to realize that itв ™s not something that you pursue and get, but rather itв ™s something that you have already until you disturb it.	Они - мощные инструменты для трансформации, для успокоения нашей души и тела, позволяющие нам понять что значит быть счастливым, быть спокойным и радостным и осознать, что счастье - это не то, что ищешь и находишь, а скорее то, что у нас уже есть, пока мы не разрушили его. 
And, you know, I'm happy to say, I think there's really evidence that this non-zero-sum kind of connection can expand the moral compass.	Я рад, что имеются веские, на мой взгляд, доводы в пользу того, что эта взаимозависимость с ненулевой суммой может расширить наш этический ареал. 
It doesn't recognize an ironic smile, or a happy smile, or a frustrated smile.	Не распознавалась ироническая улыбка или счастливая улыбка, или разочарованная улыбка. 
Fashion designer Isaac Mizrahi spins through a dizzying array of inspirations - from "50s pinups to a fleeting glimpse of a woman on the street who makes him shout "Stop the cab!" Inside this rambling talk are real clues to living a happy, creative life.	Дизaйнep-модельер Айзек Мизрахи кружит в ошеломляющем потоке вдохновения: от постеров 50-х до случайно промелькнувшей дыре в майке, заставлящей его кричать: "Остановите такси!". Внутри этой хаотичной лекции настоящие ключи к счастливой, творческой жизни. 
And this has to do with being happy, I swear.	И, клянусь, мы были счастливы. 
So, I wanted to say, Paul, I'm happy you're here, because I know you have my back.	Так что, я хочу сказать: "Пол, я счастлива, что ты здесь, потому что ты за моей спиной" 
I'm going to think of how other people can be happy.	Я буду думать о том, как другие могут быть счастливы. 
And the first person who gets happy when you do that, you don't do anything for anybody else, but you get happier, you yourself, because your whole perception broadens and you suddenly see the whole world and all of the people in it.	И первый человек, который становится счастливым, когда вы это делаете, а вы больше не делаете ничего для кого-нибудь еще, но вы уже более счастливы, вы сами, потому что ваше восприятие раздвигается, и вы вдруг видите весь мир и всех людей в нем. 
And he has been very happy.	И он очень счастлив. 
And I'm happy to say that there are several very promising developments in this area, looking at the impact of shipping on whales.	И я очень рад сообщить, что в этой области есть очень многообещающие изменения, в области влияния судоходства на китов. 
You can view it in sort of geopolitical terms and say, why is it that a billion people on this planet are so desperately needy that they have no possibility of happiness, and whereas almost all the rest of them, regardless of how much money they have - whether it's two dollars a day or whatever - are almost equally happy on average?	Вы можете рассматривать это с геополитической точки зрения и заявить, почему же миллиард людей на этой планете так сильно нуждаются, что у них нет возможности на счастье, тогда как почти все остальные, невзирая на то сколько у них денег, было два доллара в день или независимо сколько, в среднем, почти одинаково счастливы? 
I can't tell if she's happy or sad, and I change my mind all the time.	Я не могу сказать, счастлива она или грустна, и я постоянно меняю мнение. 
And that lack of resolution, the lack of resolution in "Girl with a Pearl Earring" - we don't know if she's happy or sad.	Опять же, как и в "Девушке с жемчужной серёжкой", разгадка отсутствует: мы не знаем, счастлива она или нет. 
I've written an entire novel about her, and I still don't know if she's happy or sad.	Я написала о ней целый роман, но до сих пор не знаю, счастлива она или нет. 
People know now that I'm enthusiastic, that I'm a happy person."	"Теперь людям понятно, что я - энтузиаст и счастливый человек". 
If you do cosmetic surgery, patients are often less happy.	При косметической пластике, зачастую пациенты не остаются такими довольными. 
If we can understand this, then maybe we can figure out how people can be so happy with this.	Если мы сможем это понять, то, вероятно, мы сможем выяснить, как люди могут быть довольны такой ситуацией. 
I said, "She'll be happy. She'll ring you up on the mobile."	Я сказал: "Она будет счастливой. Она позвонит вам на мобильник." 
Our "psychological immune system" lets us feel truly happy even when things donв ™t go as planned.	Наша "психоимунная система" позволяет нам чувствовать себя счастливыми даже тогда, когда вещи идут не так, как мы задумали. 
Dan Gilbert asks, Why are we happy?	Дэн Гилберт спрашивает, "Почему мы счастливы?" 
Because the fact is that a year after losing the use of their legs, and a year after winning the lotto, lottery winners and paraplegics are equally happy with their lives.	Потому что судя по статистике через год после потери возможности ходить и через год после лотерейного выигрыша как победители, так и инвалиды одинаково счастливы в своих жизнях. 
Who are these characters who are so damn happy?	Кто эти настолько счастливые люди? 
What kind of economic engine would keep churning if we believed that not getting what we want could make us just as happy as getting it?	Какая экономика не загнулась бы, если бы мы все знали, что не получив чего-то можно быть не менее счастливым, чем получив? 
You find a way to be happy with what's happened.	Вы всегда найдете способ быть счастливым с тем, что имеете. 
Basically, no one's very happy.	По существу, никто не доволен. 
Are they happy?	Счастливы ли они? 
My sister and I grew up here, and we had quiet, happy childhoods.	Моя сестра и я выросли здесь, и у нас было спокойное, счастливое дество. 
"Money does not make me happy" appeared first as double-page spreads in a magazine.	"Деньги не делают меня счастливым" - это впервые появилось на нескольких журнальных разворотах. 
It said, "Money does does make me happy."	Там было написано: "Деньги делают делают меня счастливым". 
It just says "Money," and if you look down the side street, it says, "does not make me happy."	и там просто написано "Деньги", а когда вы глянете вдоль боковой улицы, там написано, "не делают меня счастливым". 
How come you're so happy?"	Как он может быть таким довольным?" 
It's been where I actually see heaven, where I can be happy, where I can be a child again, in dances, through music.	Через неё я увидел небеса, где я могу быть счастлив, где я могу снова стать ребёнком, танцевать. 
On September 10, the morning of my seventh birthday, I came downstairs to the kitchen, where my mother was washing the dishes and my father was reading the paper or something, and I sort of presented myself to them in the doorway, and they said, "Hey, happy birthday!" And I said, "I'm seven."	10 сентября, в утро моего седьмого дня рождения я спустилась в кухню, где моя мать мыла посуду, а отец читал газету или что-то вроде того, и я как бы предстала перед ними в проходе, и они сказали: "Привет, с днём рождения." А я сказала: "Мне семь." 
Now, I was raised in the Pacific Northwest, around a lot of Church of Latter-day Saints people and, you know, I've worked with them and even dated them, but I never really knew the doctrine or what they said to people when they were out on a mission, and I guess I was, sort of, curious, so I said, "Well, please, come in." And they looked really happy, because I don't think this happens to them all that often.	Я выросла на Тихоокеанском Северо-Западе Штатов, вблизи множества людей из Церкви Последних Свяых и, знаете, я с ними работала, и даже ходила с ними на свидания, но никогда на самом деле не знала их доктрины или того, о чём они рассазывали людям на своих миссиях, и, наверное, мне стало как-то любопытно, и поэтому я сказала: "Ну, что ж, пожалуйста, заходите." И они выглядели очень счастливыми, потому что не думаю, что такое им так часто доводиться испытать. 
I'm happy without it."	Я довольна без неё." 
He introduces the Happy Planet Index, which tracks national well-being against resource use .	Он знакомит нас с Индексом Счастливой Планеты, который связывает благополучие нации с использованием природных ресурсов . 
The Happy Planet Index	Индекс Счастливой Планеты 
And what we do, is we say that the ultimate outcome of a nation is how successful is it at creating happy and healthy lives for its citizens.	Вот что мы сделали: мы сказали, что конечный результат деятельности государства состоит в том насколько успешно у властей получается создать счастливую и благополучную жизнь для своих граждан. 
And then we're starting to create a happy planet.	И затем мы начнём создавать счастливую планету. 
Human beings want to be happy.	Люди хотят быть счастливыми. 
And we need to have signposts gathering people together and pointing them - something like the Happy Planet Index.	Также нам понадобятся указатели, которые соберут людей вместе и направят их - что-то вроде Индекса Счастливой Планеты. 
I was doing my taxes the other day, and I got to the point where I was listing all of the donations I gave, and I had an epiphany, it was - I came to my check to the Seva Foundation and I noticed that I thought, boy, my friend Larry Brilliant would really be happy that I gave money to Seva.	На днях я заполнял налоги, и я дошёл до пункта, где я перечислял все свои пожертвования, и тут меня озарило, когда я добрался до чека, выписанного Фонду Сева: я поймал себя на мысли, что мой друг, Ларри Бриллиант, был бы счастлив узнать о том, что я финансово поддержал Фонд. 
And I was happy to see that at the party last night that he was still saying, very forcibly, "It's really important to have a lot of data."	И я был рад увидеть, что вчера на вечеринке он повторял с большой убеждённостью, что "очень важно обладать данными". 
Work doesn't make you happy, does it?	Ведь работа не делает нас счастливыми? 
So, hopefully this will bring back some happy, or possibly some slightly disturbing memories.	Ну, будем надеяться, что сейчас вспомнятся счастливые или, возможно, слегка волнительные моменты. 
What Howard did is he fundamentally changed the way the food industry thinks about making you happy.	Говард в корне изменил представление пищевой промышленности о том, как сделать вас счастливыми. 
Assumption number one in the food industry used to be that the way to find out what people want to eat - what will make people happy - is to ask them.	В пищевой промышленности предположение номер один было таким: чтобы выяснить, что именно люди хотят съесть, что сделает их счастливыми, нужно спросить их. 
And everyone's take-home lesson from that was that the way to get to make people happy is to give them something that is more expensive, something to aspire to.	Но урок, который все получили, был в том, что способ сделать людей счастливыми это дать им нечто более дорогое, нечто, к чему нужно стремиться. 
Because we thought that what it took to make people happy was to provide them with the most culturally authentic tomato sauce, A;	Потому что мы думали, что для того, чтобы сделать людей счастливыми, нужно предоставить им наиболее традиционный томатный соус. 
The difference between coffee at 60 and coffee at 78 is a difference between coffee that makes you wince, and coffee that makes you deliriously happy.	Отличие между кофе с оценкой 60 и кофе с оценкой 78 это отличие между кофе, который заставит вас поморщиться, и кофе, который сделает вас безумно счастливыми. 
I am so happy that my students did this campaign.	Я так рада, что мои ученики приняли участие в этой кампании! 
Marissa, her father died in her hand, I think she'd be quite happy if corporate America could start feeding their staff properly.	Марисса, у которой отец умер у нее на руках, я думаю, она была бы счастлива, если бы корпаротивная Америка могла начать кормить своих сотрудников качественно. 
I thought that only idiots were happy, to be honest.	Если честно, то я думала, что счастливы только идиоты. 
And everyone was supposed to be happy in that community and, in fact, my life was hell.	В таком обществе всем полагалось быть счастливыми, но на самом деле моя жизнь была кромешным адом. 
And then you find these things and you're happy or unhappy.	А затем находите ответ, и вы счастливы либо несчастливы. 
I'm really glad to say - recently, we've been in correspondence with Ryan - that this story had a happy ending.	С радостью могу сказать, что мы переписывались с Райаном, и у этой истории счастливый конец. 
Don Norman on 3 ways good design makes you happy	Дoн Норман о трех составляющих дизайна, которые делают вас счастливым 
And when you're happy - what we call positive valence - you squirt dopamine into the prefrontal lobes, which makes you a breadth-first problem solver:	А когда вы счастливы, это то, что мы называем позитивной валентностью, происходит впрыск дофамина в предлобные доли, что помогает вам мыслить шире. 
With brainstorming we make you happy, we play games, and we say, "No criticism," and you get all these weird, neat ideas.	Мозговые штурмы делают нас счастливее, мы играем в игры и говорим "Нет" критике, и рождаются все эти странные, интересные идеи. 
The brain works differently if you're happy. Things work better because you're more creative.	Таким образом, мозг работает по другому и если вы счастливы, то всё получается лучше, потому что вы работаете более творчески. 
But I was in Milan and saw this street sign, and was very happy to see that apparently this idea of minimalism has even been translated by the graffiti artist.	Но я был в Милане и увидел этот дорожный знак, и был очень рад увидеть, как, очевидно, эта идея минимализма была интерпретирована художником граффити. 
There's very few times you'd be happy to find this on your car, but it did seem to indicate that we were coming back.	Очень мала вероятность, что вы будете рады, увидев такое на вашей машине, но, похоже, это означало, что мы возвращаемся к прежней жизни. 
And I'm happy to say, I was partly responsible for that cliche that machines are becoming biological, but that's pretty evident.	Я счастлив говорить, что я отчасти ответственен за это клише о том, что машины становятся биологическими, но это достаточно очевидно. 
Happy face? Sad face? Sleepy face? Anybody do that?	Счастливый смайл, грустный, сонный? Кто-нибудь так делал? 
And a lot of licit banks were also happy to accept deposits from very dubious sources without questions being asked.	Многие законные банки были только рады принять вклады из очень сомнительных источников не задавая никаких вопросов. 
Imagine whenever you meet any other person, any time you meet a person, your habitual, instinctive first thought is, "I want you to be happy.	Представьте, что каждый раз, когда вы встречаете любого другого человека, каждый раз, когда вы встречаете этого человека, ваша привычная, инстинктивная первая мысль - это: "Я хочу, чтобы вы были счастливы. 
I want you to be happy."	Я хочу, чтобы вы были счастливы". 
I want to quote this guy - the guy in robes, not the other guy - the Dalai Lama, who said, "If you want others to be happy, practice compassion.	Я хочу процитировать этого человека - человека в мантии, не другого парня - Далай Ламу, который сказал: "Если хочешь, чтобы другие были счастливы, практикуй сопереживание. 
If you want to be happy, practice compassion."	Если хочешь быть счастлив сам, практикуй сопереживание". 
I end always, because I'm sure the questions are - and I'd be happy to talk to you at any point - "But what can I really do?"	Я знаю, у вас еще остались вопросы, я рада поговорить с вами в любой момент - "Но что конкретно я могу сделать?" 
Most of my professors were all for it, and they said, "Bring pictures and show me the clips online," and "I'm happy for you."	Большинство профессоров были за, они говорили "привези фотографии", "покажешь мне ролики в интернете" и "рад за тебя". 
And that makes a happy family.	Это делает семью счастливой. 
Living a nomadic existence has been hard at times, but it's allowed me to live in beautiful places and keep a balance in my life that I've been happy with.	Вести кочевую жизнь бывало непросто, но зато я смог пожить в красивых местах и сохранить гармонию, чем я очень доволен. 
He was so happy.	Он был так счастлив. 
Obviously, he's had his vasectomy because his hotdog is half eaten, and he was very happy.	Очевидно, он сделал вазектомию, потому что его хот-дог наполовину съеден, и он был счастлив. 
So they were happy with that.	И они были рады этому. 
But I was happy to pay it, because for every blow that I received, I was able to deliver two.	Но я рада была ее платить, потому что на каждый удар я отвечала двумя. 
We find that if we get them out of institutions and into loving families early on, they recover their developmental delays, and go on to lead normal, happy lives.	Согласно нашим исследованиям, чем раньше ребёнок принимается в любящую семью, тем скорее восстанавливается его развитие, и он вновь живёт полной, счастливой жизнью. 
But he's not happy; something's wrong.	Но он не доволен - что-то не так. 
He removes it, the problems are solved, everybody in the palazzo is happy.	Он высвобождает антенну - проблема решена, и все в палаццо счастливы 
Happy to see so many fine folks out here and so many smiling faces.	Я счастлив видеть здесь столько прекрасных людей и множество улыбающихся лиц. 
Happy New Year’s to you and yours! **	Счастливого Нового Года Вам и Вашим близким! ** 
The Governor was happy with the market pushing back its expectation for rate hikes, and the market now expects a more gradual pace of rate increases compared to August.	Управляющий доволен, что рынок переносит свои ожидания по поводу повышения ставок, и рынок сейчас предполагает более постепенный темп повышения ставок по сравнению с августом. 
If large investors aren’t willing to take a risk on Tesco then the stock price could struggle to gain traction until larger investors are happy that the industry has turned a corner.	Если крупные инвесторы не хотят брать на себя риск по Tesco, то курсу акции будет непросто наращивать обороты, пока боле крупные инвесторы не будут довольны, что индустрия пошла на поправку. 
The tepid response in the stock market (up 1%) suggests that domestic investors are happy but not overjoyed.	Невозмутимая реакция на фондовом рынке (до 1%) предполагает, что отечественные инвесторы рады, но не вне себя от радости. 
But so far, the Greek government seems to be favoring its creditors over its voters, which should keep the markets happy.	Но до сих пор, греческое правительство, кажется выбирает кредиторов над своими избирателями, и это должно делать рынки довольными. 
Because of the technical set-up and recent price action showing GBP weakness across the board, we’re happy to consider this trade with the stop above the cloud.	Благодаря недавнему поведению цены, показывающей слабость GBP со всеми кроссами, мы счастливы рассмотреть эту сделку со стопом выше облака. 
Since I was trading completely independently and am no longer running my program I’m happy to tell all.	Поскольку я торговал совершенно независимо и больше не использую свою программу, то счастлив рассказать вам обо всем. 
This may seem like a minor point, but if your trading venture doesn't succeed financially, you can't even fall back to the - "well, at least I made a lot of people happy, more productive, etc.".	Это может казаться незначительным аргументом, но если ваше трейдинговое предприятие не принесло финансового успеха, вы даже не можете сказать себе: “ну, по меньшей мере я сделал каких-то людей счастливыми, более продуктивными и т.д.”. 
The AP (and the ETF) are happy to create shares until the increased supply has driven the market price down close to the iNAV value.	AP (и ETF) рады создавать акции, пока увеличенная поставка уменьшает рыночную цену до уровня стоимости iNAV. 
Our community and expert traders will be happy to help:	Наши пользователи и эксперты по торговле будут рады помочь: 
For any questions you might have left, our community and our experts are happy to help you in our forums:	Если у вас останутся какие-либо вопросы, то наше сообщество и эксперты будут рады помочь вам на наших форумах: 
Absence of conflict may not mean a basically happy relationship so much as fear of the consequences of conflict.	Отсутствие конфликта может означать не столько счастливые взаимоотношения, сколько опасение последствий конфликта открытого.
This means that the happy investor in these securities will be in one of the few industries which will in no sense feel the next business depression, which sooner or later will be felt by most other industries.	Это означает, что счастливый инвестор, владеющий этой разновидностью ценных бумаг, окажется связанным с одной из очень немногих отраслей, которая не почувствует ближайшего спада деловой активности, который, рано или поздно, придется пережить другим отраслям. 
When things were slow, I found it less unpleasant to analyze in great detail just how I would build up my business when the happy day that I would no longer be wearing a uniform might arise than it was to think of the personal living and Army type problems with which, from a short-range point of view, I was confronted.	Когда дел было мало, мне было приятнее подробно анализировать, как можно будет выстроить свой бизнес в то счастливое время, когда не нужно будет больше носить униформу, — это было приятнее, чем размышлять о личных делах или армейских проблемах, с которыми я сталкивался на том коротком отрезке жизненного пути. 
EXNESS client support is always happy to help traders resolve any issue.	Служба поддержки клиентов EXNESS всегда рада помочь трейдерам в решении любого вопроса. 
For any questions you may have, you can contact us directly via telephone or Live Chat and we'll be more than happy to assist!	Если у Вас есть какие-либо вопросы, вы можете связаться с нами по телефону или с помощью чата, и мы будем рады Вам помочь! 
Topic: Banking
Contact us and we’ll be happy to provide further explanation to any questions you may have!	Свяжитесь с нами, и мы будем рады ответить на все Ваши вопросы! 
If you have any other questions or concerns, we are happy to talk to you about the many steps UFXMarkets takes to keep your trading safe and secure.	Если у вас есть другие вопросы, мы будем рады поговорить с вами о многочисленных мерах, которые UFXMarkets принимает для обеспечения безопасности вашей торговли. 
In other words, XGLOBAL Markets is extremely happy to offer a transparent and a straightforward trading experience to all of you.	Иными словами, брокер XGLOBAL Markets счастлив предоставить вам самые простые и удобные условия торговли. 
